1 1 1 1 1 1 1 1 1 1 1 1 1 1 1 1 1 1 1 1 1 1 1 1 1 1 1 1 1 1 1
1 2 3 3 3 3 3 3 3 3 3 3 3 3 3 3 3 3 3 3 3 3 3 3 3 3 3 3 3 4 1
1 5 0 0 c 0 b 0 0 0 0 0 0 0 0 0 b 0 c 0 0 0 0 0 0 0 0 0 0 9 1
1 5 0 c 0 0 0 0 0 0 0 0 0 0 0 0 0 0 0 0 0 0 0 0 b 0 0 0 0 9 1
1 5 0 0 0 0 0 0 0 0 0 0 0 b b c 0 b 0 0 0 0 0 0 0 0 0 0 0 9 1
1 5 0 0 0 b 0 0 0 0 0 0 0 0 0 0 0 0 0 0 0 0 0 b 0 0 0 0 0 9 1
1 5 0 0 0 0 0 0 0 0 0 0 0 0 0 0 0 0 0 0 0 0 0 0 c 0 0 0 0 9 1
1 5 0 0 0 0 0 0 0 c 0 0 0 0 0 0 0 0 0 0 0 0 0 0 0 c 0 0 0 9 1
1 5 b c b 0 c 0 0 0 b 0 0 0 0 0 0 c 0 0 0 0 0 0 b 0 b 0 0 9 1
1 5 0 0 c 0 0 0 0 0 0 0 0 0 0 0 0 0 0 0 0 0 0 0 0 0 0 0 0 9 1
1 5 0 0 0 0 0 0 b 0 0 0 c 0 0 0 0 0 0 0 0 0 0 0 0 b 0 0 0 9 1
1 5 0 0 c b c c 0 0 0 0 0 b 0 0 0 0 0 b c 0 0 0 0 b 0 0 0 9 1
1 5 0 0 0 0 0 0 c 0 0 0 0 0 c 0 0 0 0 0 0 0 0 0 0 c 0 0 0 9 1
1 5 0 0 0 0 0 0 0 0 b 0 0 c 0 0 0 0 0 0 0 0 c c 0 0 0 0 0 9 1
1 5 0 0 b 0 0 0 b 0 0 0 0 0 b 0 0 0 0 0 c 0 0 0 0 b 0 0 0 9 1
1 5 0 0 0 0 0 0 0 0 0 0 0 0 0 0 0 0 0 0 0 0 0 0 0 0 0 0 0 9 1
1 6 7 7 7 7 7 7 7 7 7 7 7 7 7 7 7 7 7 7 7 7 7 7 7 7 7 7 7 8 1
1 1 1 1 1 1 1 1 1 1 1 1 1 1 1 1 1 1 1 1 1 1 1 1 1 1 1 1 1 1 1